
   {
      {
         { 255, 4,15,15,15, 4,15,15,15, 4,15,15,15 },
         { 0, 4, 5, 2, 7, 4, 9, 2,11, 4,13, 2, 3 },
         { 1, 4, 5, 8, 7, 4, 9,12,11, 4,13, 2, 3 },
         { 1, 4, 5, 4, 7, 4, 9, 4,11, 4,13, 4, 3 },
         { 1, 4, 5, 4, 7, 4, 9, 4,11, 4,13, 4, 3 },
         { 1, 4, 5, 4, 7, 4, 9, 4,11, 4,13, 4, 3 },
         { 1, 2, 5, 4, 7, 4, 9, 4,11, 4,13, 4, 3 },
         { 1, 6, 5, 4, 7,10, 9, 4,11,14,13, 4, 3 },
         { 1,16, 5, 4, 7, 2, 9, 4,11, 2,13, 4, 3 },
         {15,15,15, 4,15,15,15, 4,15,15,15, 4, 3 }
      }
   },
