
   {
      {
         { 255, 0, 2, 2, 5, 5, 5, 5, 5, 2, 2, 0, 0 },
         { 0, 0, 8, 8, 7, 7, 7, 7, 7, 6, 6, 0, 0 },
         { 0, 0, 8, 8, 0, 0, 0, 0, 0, 6, 6, 0, 0 },
         { 0, 0, 1, 1, 0, 0, 0, 0, 0, 1, 1, 0, 0 },
         { 0, 0, 0, 0, 0, 3, 3, 0, 0, 0, 0, 0, 0 },
         { 0, 0, 0, 0, 0, 3, 3, 0, 0, 0, 0, 0, 0 },
         { 0, 0, 1, 1, 0, 0, 0, 0, 0, 1, 1, 0, 0 },
         { 0, 0, 6, 6, 0, 0, 0, 0, 0, 8, 8, 0, 0 },
         { 0, 0, 6, 6, 7, 7, 7, 7, 7, 8, 8, 0, 0 },
         { 0, 0, 2, 2, 5, 5, 5, 5, 5, 2, 2, 0, 0 }
      }
   },
