
   {
      {
         {255, 0, 4,16, 0, 2, 2, 2, 2, 2, 2, 2, 2 },
         { 0, 0, 4,10, 0, 7, 7, 7, 7, 7, 7, 7, 2 },
         { 0, 1, 4,14, 0,11,11,11,11,11,11,11, 2 },
         { 1, 0, 4, 6, 0, 5, 5, 5, 5, 5, 5, 5, 2 },
         { 0, 1, 4,12, 0,13,13,13,13,13,13,13, 2 },
         { 1, 0, 4, 8, 0, 9, 9, 9, 9, 9, 9, 9, 2 },
         { 0, 1, 4, 2, 0,15,15,15,15,15,15,15, 2 },
         { 1, 0, 1, 0, 1, 0, 1, 0, 1, 0, 1, 0, 1 },
         { 0, 3, 0, 3, 0, 3, 0, 3, 0, 3, 0, 3, 0 },
         { 2, 0, 2, 0, 2, 0, 2, 0, 2, 0, 2, 0, 2 }
      }
   },
