   {
      {
         {255, 0, 0, 0, 0, 0, 0, 0, 0, 0, 0, 0, 0 },
         { 0,15,15,15, 0, 0, 0, 0, 0,13,13,13, 0 },
         { 0,15,15, 0, 0, 0, 0, 0, 0, 0,13,13, 0 },
         { 0,15, 0, 0, 0, 0, 2, 0, 0, 0, 0,13, 0 },
         { 0, 0, 0, 0, 0, 2, 1, 2, 0, 0, 0, 0, 0 },
         { 0, 0, 0, 0, 2, 1, 1, 1, 2, 0, 0, 0, 0 },
         { 0, 0, 0, 2, 1, 0, 3, 0, 1, 2, 0, 0, 0 },
         { 0, 0, 2, 1, 0, 0, 3, 0, 0, 1, 2, 0, 0 },
         { 0, 2, 1, 0, 0, 0, 3, 0, 0, 0, 1, 2, 0 },
         { 0, 0, 0, 0, 0,14, 2,16, 0, 0, 0, 0, 0 }
      }
   },
